R 1000 650
NO ./img/wood.xpm
SO ./img/bluestone.xpm
WE ./img/greystone.xpm
EA ./img/redbrick.xpm

F 200,200,80
C 0,255,255


11111111111111111111
10000000000000000001
10000111111000000001
1000000000100000S001
10100000001000000001
10100000000000000001
10100000000000000001
10100000000000000001
10000000000001111001
10000000001111000001
10010000000000001001
10000000000000000001
11111111111111111111
