F 		200,		200,   80


SO 			./text/orig/bluestone.xpm


R    1100    600
NO       ./text/orig/wood.xpm
WE   ./text/orig/greystone.xpm
EA		./text/orig/eagle.xpm


C 0,255,255

S  ./text/orig/pillar.xpm

11111111111111111111
10000000000000000001
10000000000000011111
1111000002000001
   10000000000011111
   10000000000000001
111100000000000S0001
10000000000000000001
10000000000000000001
10002000000000000001
10000000000000000001
10000000000000000001
11111111111111111111
