F 		200,		200,   80


SO 			./img/bluestone.xpm


R    1280    832
NO       ./img/wood.xpm
WE   ./img/greystone.xpm
EA		./img/eagle.xpm

C 0,	0,      0


11111111111111111111
10000000000000000001
10000000000000011111
1111000000000001
   10000000000011111
   10000000000000001
111100000000000S0001
10000000000000000001
10000000000000000001
10000000000000000001
10000000000000000001
10000000000000000001
11111111111111111111
