F 		200,		200,   80


SO 			./text/orig/bluestone.xpm


R    1100    600
NO       ./text/orig/wood.xpm
WE   ./text/orig/greystone.xpm
EA		./text/orig/eagle.xpm


C 0,50,155

S  ./text/orig/pillar.xpm

1111111111      1111111111111      111111111111
1000010001      1000001000001      100000000201
1000000001      1000001000001      100000000001
1111111001      1000201000001      100001110001
      1001      1000000000001      100001000001
11111110011111111000000000001111111100001000001
10000000000000000000000000000000000000001000001
10020000000000000100000000001000000000001000001
1111111111111111111100N011111111111111111011111
                   100001               101
                   100001               101
11111111111111111111000011111111111111111011111
10000000000000000000000000000000000000000000001
10000000000000000000001000000000000000000000001
11111110011111111000001000111111111100111111111
      1001      1000001000001      1001
11111110011111111110001000001111111100111111111
10000000000000000000001000000000000000000000201
10000000011111111000001000001111111100000000001
1000200001      1000001000001      100000000001
1111111111      1111111111111      111111111111
