

F 		200    ,			200  , 80

SO 			./img/eagle.xpm

R    900   600
NO       ./img/eagle.xpm
WE   ./img/eagle.xpm
EA  ./img/eagle.xpm

C 0,255,255



11111111111111111111111
10000000000000010000001
10000000000000010000001
10000000000000010000001
10000000E00000010000001111111111
10000000000000010000000000000001
11110000000000010000000000000001
   10000000000000000000000000001
   10000000000000000000000111111
111111111111100000000000001
100000000000000000000000001
10000000000000111100000000111111
100000000000001  100000000000001
10000000000000111100000000000001
10001111111100000011111111111111
10001      10000001
10001      10000001
11111      11111111
