
S  ./img/space/astro.xpm
F 		200    ,			200  , 80

SO 			./img/space/42sp.xpm

R    900   600
NO       ./img/space/42.xpm
WE   ./img/space/dark.xpm
EA  ./img/space/dark2.xpm

C 0,255,255



11111111111111111111111
10000000000000010000001
10000000000000010000001
10000000S00000010000001
10000000000000010000001111111111
10002000000000010000000000000001
11110000000000010000000000000001
   10000200000000000000000000001
   10000000000000000000000111111
111110020000000000000000001
100000000000000000000000001
1000000002000111100000000011111
10000000000001  100000000000001
1000002000000111100000000000001
1000111111110000001111111111111
10001      10000001
10001      10000001
11111      11111111
