
S  ./text/orig/pillar.xpm
F 		200    ,	200  , 80

SO 	./text/orig/eagle.xpm

R    3000   2000
NO       ./text/orig/eagle.xpm
WE   ./text/orig/eagle.xpm
EA  ./text/orig/eagle.xpm

C 0,255,255



11111111111111111111111
10000000000000010000001
10000000000000010000001
10000000200000010000001
10000000000000010000001111111111
10000000000000010000000000000001
11110000000000000000002000000001
   10000200000000000000000000001
   10000000000000000000000111111
111110000000000000000000001
100000000000000N00000000001
1000000000000111100000000011111
10020000000001  100000000000001
1000000000000111100000000000001
1000111111110000001111111111111
10001      10000001
10001      10000001
11111      11111111
