
S  ./img/earth.xpm
F 122 ,	122 , 80

SO 	./img/eagle.xpm

R    950   500
NO  ./img/eagle.xpm
WE ./img/eagle.xpm
EA  ./img/eagle.xpm

C 0,0,102


            1111111111111111
            1000001000000001
            1000001000000001
            100000100000000111111111
            100000100000000100000001
111111111111100011111110000100020001
100000000000000000000000000100000001
10000200000000000S000000000100000001
100000000000100000000000000000000001
111111111000111111111100011111111111
1000000000001        100000000100001
1000000000001        100000000000001
100011111111111111111111110000111111
1000100000000000000001000000001
1000100000001000000001000000001
1000000000001000000000000000001
1111111111111111111111111111111
