R 3000 2000
NO ./text/space/42sp.xpm
WE ./text/space/dark.xpm
EA ./text/space/dark2.xpm
SO ./text/space/space1.xpm
S ./text/space/astro.xpm
F 122, 122, 80
C 0,0,102



            1111111111111111
            1000001000000001
            1000001002000001
            100000100000000111111111
            100000100000000100000001
111111111111100011111110000100020001
100000000000000000000000000100000001
10000200000000000W000000000100000001
100000000000100000000000000000000001
111111111000111111111100011111111111
1000000000001        100000000100001
1000002000001        100000000000001
100011111111111111111111110000111111
1000100000000000000001000000001
1000100000001000020001000000001
1000000000001000000000000000001
1111111111111111111111111111111
