

R 980 600
NO ./text/random/3.xpm
WE ./text/random/8.xpm
EA ./text/random/2.xpm
SO ./text/random/7.xpm
S ./text/random/sprite.xpm
F 122, 122, 80
C 0,0,102





  11111111  1111111111111111
  10000001111000001000000001
  10020000000000001000000001
  1000000111100000100000000111111111
  11111111  100000100020000000000201
            100000100000000100000001
111111111111100011111110000100000001
120000000002000000000000000111111001
100000010000000000000000020000001001
100000010000100000000000000000001001
100000210000111100111100000002001001
1000111111111  1001  100000000000001
10001          1001  111111011111111
10001          1001       101
10001111111111110011111111101111111
10001000002000000000000000000000001
100000000000000000000000020000000W1
11111111111111111111111111111111111
